11111
10P01
10C01
10EE1
11111
