11111
10P01
100C1
10PE1
11111
