11111111
100000P1
10C11C01
1000E001
11111111
