11111111111111111111111111111111
1C0001000C11000C1C10100010C11C11
11100101101100111010101000100011
10001001000100000000100010001001
10100010010001111C11111111111101
1C111000111011010001010101C11001
11011111110001010001010101011001
10011110011101000100000000000001
1P0000000000000000000000000000E1
11111111111111111111111111111111
