11111
10P01
10C01
1E001
11110
