11111
10P01
10001
10C01
11111
