11111
1CEP1
10001
11111
11111
