111111
1C1EP1
101001
1C0001
111111
