111111
1C10P1
101001
1Q00E1
111111
